F 220,100,0
C 0,0,0
NO ./textures/north.xpm
SO ./textures/south.xpm
WE ./textures/west.xpm
EA ./textures/east.xpm


11111111111111111111111111111111111111111111111111111111111111111111111111
10000000000000000000000000000000000000000000000100000000000000000000000001
10000000000000000000000000000000000000000000000100000000000000000000000001
10000000000000000000000000000000000000000000000100000000000000000000000001
10000000000000000000000000000000000000000000000100000000000000000000000001
10000000000000000000000000000000000000000000000100000000000000000000000001
10000000000000000000000000000000000000000000000100000000000000000000000001
10000000000000000000000000000000000000000000000100000000000000000000000001
10000000000000000000000000000000000000000000000100000000000000000000000001
10000000000000000000000000000000000000000000000100000000000000000000000001
10000000000000000000000000000000000000000000000100000000000000000000000001
10000000000000000000000000000000000000000000000100000000000000000000000001
10000000000000000000000000000000000000000000000100000000000000000000000001
10000000000000000000000000000000000000000000000100000000000000000000000001
10000000000000000000000000000000000000000000000100000000000000000000000001
10000000000000000000000000000000000000000000000100000000000000000000000001
10000000000000000000000000000000000000000000000E00000000000000000000000001
10000000000000000000000000000000000000000000000 00000000000000000000000001
10000000000000000000000000000000000000000000000 00000000000000000000000001
10000000000000000000000000000000000000000000000 00000000000000000000000001
10000000000000000000000000000000000000000000000 00000000000000000000000001
10000000000000000000000000000000000000000000000 00000000000000000000000001
10000000000000000000000000000000000000000000000 00000000000000000000000001
10000000000000000000000000000000000000000000000 00000000000000000000000001
10000000000000000000000000000000000000000000000 00000000000000000000000001
10000000000000000000000000000000000000000000000 00000000000000000000000001
10000000000000000000000000000000000000000000000 00000000000000000000000001
10000000000000000000000000000000000000000000000 00000000000000000000000001
10000000000000000000000000000000000000000000000 00000000000000000000000001
10000000000000000000000000000000000000000000000 00000000000000000000000001
10000000000000000000000000000000000000000000000 00000000000000000000000001
10000000000000000000000000000000000000000000000 00000000000000000000000001
10000000000000000000000000000000000000000000000 00000000000000000000000001
10000000000000000000000000000000000000000000000 00000000000000000000000001
10000000000000000000000000000000000000000000000 00000000000000000000000001
10000000000000000000000000000000000000000000000 00000000000000000000000001
10000000000000000000000000000000000000000000000 00000000000000000000000001
10000000000000000000000000000000000000000000000 00000000000000000000000001
10000000000000000000000000000000000000000000000 00000000000000000000000001
10000000000000000000000000000000000000000000000 00000000000000000000000001
10000000000000000000000000000000000000000000000 00000000000000000000000001
10000000000000000000000000000000000000000000000 00000000000000000000000001
10000000000000000000000000000000000000000000000 00000000000000000000000001
10000000000000000000000000000000000000000000000 00000000000000000000000001
10000000000000000000000000000000000000000000000 00000000000000000000000001
10000000000000000000000000000000000000000000000 00000000000000000000000001
10000000000000000000000000000000000000000000000 00000000000000000000000001
10000000000000000000000000000000000000000000000 00000000000000000000000001
10000000000000000000000000000000000000000000000 00000000000000000000000001
10000000000000000000000000000000000000000000000 00000000000000000000000001
10000000000000000000000000000000000000000000000 00000000000000000000000001
10000000000000000000000000000000000000000000000 00000000000000000000000001
10000000000000000000000000000000000000000000000 00000000000000000000000001
11111111111111111111111111111111111111111111111111111111111111111111111111