F 220,100,0
C 0,0,0


NO ./textures/north.xpm
SO ./textures/south.xpm
WE ./textures/west.xpm
EA ./textures/east.xpm

11111111111111111111111111111111111111111111111111111111111111111111111111
10000000000000000000000000000000000000000000000 000000000000000000000000V1
10000000000000000000000000000000000000000000000 000000000000000000000000V1
10000000000000000000000000000000000000000000000 000000000000000000000000V1
10000000000000000000000000000000000000000000000 000000000000000000000000V1
10000000000000000000000000000000000000000000000 000000000000000000000000V1
10000000000000000000000000000000000000000000000 000000000000000000000000V1
10000000000000000000000000000000000000000000000 000000000000000000000000V1
10000000000000000000000000000000000000000000000 000000000000000000000000V1
10000000000000000000000000000000000000000000000 000000000000000000000000V1
10000000000000000000000000000000000000000000000 000000000000000000000000V1
10000000000000000000000000000000000000000000000 000000000000000000000000V1
10000000000000000000000000000000000000000000000 000000000000000000000000V1
10000000000000000000000000000000000000000000000 000000000000000000000000V1
10000000000000000000000000000000000000000000000 000000000000000000000000V1
10000000000000000000000000000000000000000000000 000000000000000000000000V1
10000000000000000000000000000000000000000000000E000000000000000000000000V1
10000000000000000000000000000000000000000000000 000000000000000000000000V1
10000000000000000000000000000000000000000000000 000000000000000000000000V1
10000000000000000000000000000000000000000000000 000000000000000000000000V1
10000000000000000000000000000000000000000000000 000000000000000000000000V1
10000000000000000000000000000000000000000000000 000000000000000000000000V1
10000000000000000000000000000000000000000000000 000000000000000000000000V1
10000000000000000000000000000000000000000000000 000000000000000000000000V1
10000000000000000000000000000000000000000000000 000000000000000000000000V1
10000000000000000000000000000000000000000000000 000000000000000000000000V1
10000000000000000000000000000000000000000000000 000000000000000000000000V1
10000000000000000000000000000000000000000000000 000000000000000000000000V1
10000000000000000000000000000000000000000000000 000000000000000000000000V1
10000000000000000000000000000000000000000000000 000000000000000000000000V1
10000000000000000000000000000000000000000000000 000000000000000000000000V1
10000000000000000000000000000000000000000000000 000000000000000000000000V1
10000000000000000000000000000000000000000000000 000000000000000000000000V1
10000000000000000000000000000000000000000000000 000000000000000000000000V1
10000000000000000000000000000000000000000000000 000000000000000000000000V1
10000000000000000000000000000000000000000000000 000000000000000000000000V1
10000000000000000000000000000000000000000000000 000000000000000000000000V1
10000000000000000000000000000000000000000000000 000000000000000000000000V1
10000000000000000000000000000000000000000000000 000000000000000000000000V1
10000000000000000000000000000000000000000000000 000000000000000000000000V1
10000000000000000000000000000000000000000000000 000000000000000000000000V1
10000000000000000000000000000000000000000000000 000000000000000000000000V1
10000000000000000000000000000000000000000000000 000000000000000000000000V1
10000000000000000000000000000000000000000000000 000000000000000000000000V1
10000000000000000000000000000000000000000000000 000000000000000000000000V1
10000000000000000000000000000000000000000000000 000000000000000000000000V1
10000000000000000000000000000000000000000000000 000000000000000000000000V1
10000000000000000000000000000000000000000000000 000000000000000000000000V1
10000000000000000000000000000000000000000000000 000000000000000000000000V1
10000000000000000000000000000000000000000000000 000000000000000000000000V1
10000000000000000000000000000000000000000000000 000000000000000000000000V1
10000000000000000000000000000000000000000000000 000000000000000000000000V1
10000000000000000000000000000000000000000000000 000000000000000000000000V1
11111111111111111111111111111111111111111111111111111111111111111111111111