NO ./path_to_the_north_texture
SO ./path_to_the_south_texture
WE ./path_to_the_west_texture
EA ./path_to_the_east_texture
F 220,100,0
C 255,30,1
111111111111111111111111111
100000000000000000000000001
100000001111111111000000001
100000001000000001000000001
10000000100N001001000000001111111
100000001111111000000000000000001
100000000000000000000000001111111
100000000000000000000000001
100000000000000000000000001
100000000000000000000000001
100000000000000000000000001
100000000000000000000000001
111111111111111111111111111