F 220,100,0
C 0,0,0


NO ./textures/north.xpm
SO ./textures/south.xpm
WE ./textures/west.xpm
EA ./textures/east.xpm

111111111111111111111111111
100000000000000000000000001
100000000000000000000000001
100000000000000000000000001
1000000000000000 0000000001
100000000000000000000000001
1000000000000000000000000N1
111111111111111111111111111