NO ./textures/north.xpm
SO ./textures/south.xpm
WE ./textures/west.xpm
EA ./textures/east.xpm
F 220,100,0
C 0,0,0

111111111111111111111111111111111111111111111111111111111111111111111111111111111111111111
1N0000000000000000000000000000000000000010000000000000000000000000000000000000000000000001
100000000000000000000000000000000000000010000000000000000000000000000000000000000000000001
100000000000000000000000000000000000000010000000000000000000000000000000000000000000000001
100000000000000000000000000000000000000010000000000000000000000000000000000000000000000001
100000000000000000000000000000000000000010000000000000000000000000000000000000000000000001
100000000000000000000000000000000000000010000000000000000000000000000000000000000000000001
100000000000000000000000000000000000000010000000000000000000000000000000000000000000000001
100000000000000000000000000000000000000010000000000000000000000000000000000000000000000001
100000000000000000000000000000000000000010000000000000000000000000000000000000000000000001
100000000000000000000000000000000000000010000000000000000000000000000000000000000000000001
10000000000000000000000000000000000000011110000000000000000000000000000000000000000000001
100000000000000000000000000000000000000000000000000000000000000000000000000000000000000001
1000000000000000000000000000000000000000 0000000000000000000000000000000000000000000000001
1000000000000000000000000000000000000000 0000000000000000000000000000000000000000000000001
1000000000000000000000000000000000000000 0000000000000000000000000000000000000000000000001
1000000000000000000000000000000000000000 0000000000000000000000000000000000000000000000001000000000000000000000000000000000000000000000000000000000000000000000001
111111111111111111111111111111111111111111111111111111111111111111111111111111111111111111