F 225,0,0
C 0,0,0


NO ./textures/north.xpm
SO ./textures/south.xpm
WE ./textures/west.xpm
EA ./textures/east.xpm

11111111111
100000000V1
10000N000V1
100000000V1
100000000V1
100000000V1
100000000V1
100000000V1
1VVVVVVVVV1
11111111111