NO ./textures/north.xpm
SO ./textures/south.xpm
EA ./textures/east.xpm
WE ./textures/west.xpm

F 123,0,0
C 0,0,0
1111111111111111
10000000000000N1
1        0     1
1000000000     1
10     0       1
10     000000001
10000000      01
10     0  000001
100    0       1
10   0000000   1
10             1
1000000000000001
1111111111111111